"¡" = "i"
"§" = "s"
"¢" = "c"
"ø" = "o"
"ð" = "d"
"þ" = "p"
"ß" = "b"
"ƒ" = "f"
"ł" = "l"
"ś" = "s"
"ń" = "n"
"ę" = "e"
"ç" = "c"
"ü" = "u"
"ö" = "o"
"ä" = "a"
"è" = "e"
"é" = "e"
"ê" = "e"
"ï" = "i"
"å" = "a"
"µ" = "u"
"ÿ" = "y"