"1" = "i"
"!" = "i"
"@" = "a"
"3" = "e"
"4" = "a"
"\\$" = "s"
"0" = "o"
"5" = "s"
"7" = "t"
"9" = "g"
